NO ./textures/orange.png
SO ./textures/blue.png
WE ./textures/pink.png
EA ./textures/green.png

F 220,100,0
C 225,30,0

1111111111
1000000001
1000111111
1000000001
1111111111